w=29; 
h=30;
1,1,1,1,1,1,1,1,1,1,1,1,1,1,1,1,1,1,1,1,1,1,1,1,1,1,1,1,1
1,0,0,0,0,0,0,0,0,0,0,0,0,0,1,0,0,0,0,0,0,0,0,0,0,0,0,0,1
1,0,0,0,0,0,0,0,0,0,0,0,0,0,1,0,0,0,0,0,0,0,0,0,0,0,0,0,1
1,0,0,1,1,1,0,0,1,1,1,1,0,0,1,0,0,1,1,1,1,0,0,1,1,1,0,0,1
1,0,0,1,1,1,0,0,1,1,1,1,0,0,1,0,0,1,1,1,1,0,0,1,1,1,0,0,1
1,0,0,0,0,0,0,0,0,0,0,0,0,0,0,0,0,0,0,0,0,0,0,0,0,0,0,0,1
1,0,0,0,0,0,0,0,0,0,0,0,0,0,0,0,0,0,0,0,0,0,0,0,0,0,0,0,1
1,0,0,1,1,1,0,0,1,0,0,1,1,1,1,1,1,1,0,0,1,0,0,1,1,1,0,0,1
1,0,0,0,0,0,0,0,1,0,0,0,0,0,1,0,0,0,0,0,1,0,0,0,0,0,0,0,1
1,0,0,0,0,0,0,0,1,0,0,0,0,0,1,0,0,0,0,0,1,0,0,0,0,0,0,0,1
1,1,1,1,1,1,0,0,1,1,1,1,2,2,1,2,2,1,1,1,1,0,0,1,1,1,1,1,1
2,2,2,2,2,1,0,0,1,2,2,2,2,2,r,2,2,2,2,2,1,0,0,1,2,2,2,2,2
2,2,2,2,2,1,0,0,1,2,2,2,2,2,2,2,2,2,2,2,1,0,0,1,2,2,2,2,2
1,1,1,1,1,1,0,0,1,2,2,1,4,4,4,4,4,1,2,2,1,0,0,1,1,1,1,1,1
2,2,2,2,2,2,0,0,2,2,2,1,p,b,2,y,2,1,2,2,2,0,0,2,2,2,2,2,2
2,2,2,2,2,2,0,0,2,2,2,1,2,2,2,2,2,1,2,2,2,0,0,2,2,2,2,2,2
1,1,1,1,1,1,0,0,1,2,2,1,1,1,1,1,1,1,2,2,1,0,0,1,1,1,1,1,1
2,2,2,2,2,1,0,0,1,2,2,2,2,2,2,2,2,2,2,2,1,0,0,1,2,2,2,2,2
2,2,2,2,2,1,0,0,1,2,2,2,2,2,2,2,2,2,2,2,1,0,0,1,2,2,2,2,2
1,1,1,1,1,1,0,0,1,1,1,1,2,2,1,2,2,1,1,1,1,0,0,1,1,1,1,1,1
1,0,0,0,0,0,0,0,1,0,0,0,0,0,1,0,0,0,0,0,1,0,0,0,0,0,0,0,1
1,0,0,0,0,0,0,0,1,0,0,0,0,0,1,0,0,0,0,0,1,0,0,0,0,0,0,0,1
1,0,0,1,1,1,0,0,1,0,0,1,1,1,1,1,1,1,0,0,1,0,0,1,1,1,0,0,1
1,0,0,0,0,0,0,0,0,0,0,0,0,0,3,0,0,0,0,0,0,0,0,0,0,0,0,0,1
1,0,0,0,0,0,0,0,0,0,0,0,0,0,0,0,0,0,0,0,0,0,0,0,0,0,0,0,1
1,0,0,1,1,1,0,0,1,1,1,1,0,0,1,0,0,1,1,1,1,0,0,1,1,1,0,0,1
1,0,0,1,1,1,0,0,1,1,1,1,0,0,1,0,0,1,1,1,1,0,0,1,1,1,0,0,1
1,0,0,0,0,0,0,0,0,0,0,0,0,0,1,0,0,0,0,0,0,0,0,0,0,0,0,0,1
1,0,0,0,0,0,0,0,0,0,0,0,0,0,1,0,0,0,0,0,0,0,0,0,0,0,0,0,1
1,1,1,1,1,1,1,1,1,1,1,1,1,1,1,1,1,1,1,1,1,1,1,1,1,1,1,1,1